1111111111111
10E000000P001
1000000000001
100000C000001
1000000000001
1111111111111
