1111111111111111111111111111111111
10000000000100C0000000000000001001
10P00000000100000000000000000010C1
1000000C00011100000000010000001001
10C00000000000000000C0010000000001
10000000000000000000000100E0000001
1111111111111111111111111111111111
