1111
10P1
1001
1001
10E1
1C01
1111