11111
10P01
10001
100E1
10001
1C001
11111