1111111111111
10000000P0001
10E0000000001
1000000000001
1000000C00001
1111101111111