1111111111111
1000000000001
10E00000P0001
1000000000001
1000000C00001
1111111111111