1111111111111111111111111111111111
10000000000100C0000000000000000001
10P0000000010000000000000000000001
1000000C00011100000000010000000001
10000000000000000000C0010000000001
10000000000000000000000100E0000001
1111111111111111111111111111111111
